8
1,5,7,5,5,5,5,6
3,6,11,7,7,7,6,10
11,14,11,13,13,15,14,10
11,14,10,3,6,11,14,10
11,14,10,9,14,11,14,10
11,14,11,7,15,15,14,10
11,14,11,14,9,13,12,10
9,12,9,13,5,5,5,12
