8
1,5,7,5,5,5,5,6
1,5,15,7,7,7,6,10
3,6,11,13,13,13,12,10
11,14,10,3,6,3,6,10
11,14,10,9,14,10,10,10
11,14,11,7,15,14,10,10
11,14,11,15,15,14,10,10
9,12,9,13,13,12,9,12
